1111111111111111
1P00010C000001E1
1010010000000101
1010000100C00101
1C10111001100101
100011100110C101
1000000C01100001
1111111111111111
